###########################     ################
#.........................#     #..............#
#.....................C...#     #..............#
#.........................#######..............#
#.........................|.....|..............# 
#.........................#######..............#
#....C....................#     #..............#
#.........................#     #..............#
###########################     ################
