#######################################
#.....................................#
#.....................................#
#.....................................#
#.....................................#
#.....................................#
#.....................................#
#.....................................#
#.....................................#
#.....................................#
#|############.........##############|#
#............#.........#..............#
#............#.........#..............#
#######################################
